Conjugate 'hablar' in the preterite tense for 'yo'.	Yo hablé (I spoke)
Conjugate 'comer' in the imperfect tense for 'ellos'.	Ellos comían (They used to eat)
Conjugate 'vivir' in the pluperfect tense for 'nosotros'.	Nosotros habíamos vivido (We had lived)
Fill in the blank: Ayer ella ______ (trabajar) todo el día.	trabajó (worked)
Identify the tense: 'Ellos estaban jugando cuando llegué.'	Imperfect Progressive (They were playing when I arrived)
Conjugate 'leer' in the present tense for 'yo'.	Yo leo (I read)
Conjugate 'escribir' in the present progressive for 'nosotros'.	Nosotros estamos escribiendo (We are writing)
Translate: 'She has a car.'	Ella tiene un coche.
Fill in the blank: Ahora mismo, ellos ______ (escuchar) música.	están escuchando (are listening)
Identify the tense: 'Yo hablo español todos los días.'	Present Indicative (I speak Spanish every day)
Conjugate 'hacer' in the future simple for 'ella'.	Ella hará (She will do/make)
Conjugate 'tener' in the future perfect for 'ellos'.	Ellos habrán tenido (They will have had)
Fill in the blank: Mañana nosotros ______ (viajar) a México.	viajaremos (will travel)
Translate: 'They are going to visit their grandparents tomorrow.'	Ellos van a visitar a sus abuelos mañana.
Identify the tense: 'Para entonces, habré aprendido español.'	Future Perfect (By then, I will have learned Spanish)
Conjugate 'ir' in the present tense for 'yo'.	Yo voy (I go)
Conjugate 'ser' in the imperfect tense for 'tú'.	Tú eras (You were)
Conjugate 'estar' in the present progressive for 'ellos'.	Ellos están estando (They are being)
Conjugate 'hacer' in the future simple for 'nosotros'.	Nosotros haremos (We will do/make)
Translate: 'I will be happy tomorrow.'	Seré feliz mañana.
What tense is used: 'Había terminado antes de salir.'	Pluperfect (I had finished before leaving)
Identify the tense: 'Voy a aprender español el próximo año.'	Near Future (I am going to learn Spanish next year)
What tense is this: 'Nosotros estudiábamos mientras tú trabajabas.'	Imperfect (We were studying while you were working)
Translate: 'I am writing a letter.'	Estoy escribiendo una carta.
Fill in the blank: En el futuro, ella ______ (ser) doctora.	será (will be)
